tophat tilemap,0,0,12,0
true,false
0,0,2,0,1,0,0,0,0,2,0,0
0,1,1,1,0,1,0,1,0,1,1,0
0,1,1,0,0,0,0,0,0,1,1,0
0,1,1,0,1,1,0,2,0,1,1,0
0,1,1,2,0,1,1,1,1,1,1,0
0,1,1,1,1,1,1,1,1,1,1,0
0,0,1,1,1,1,1,1,1,1,0,0
0,0,0,0,0,0,0,0,0,0,0,0
