tophat tilemap,0,0,12,0
true
0,0,0,0,0,0,0,0,0,0,0,0
0,1,1,0,0,1,0,1,0,1,1,0
0,1,1,0,0,0,0,0,0,1,1,0
0,1,1,0,1,0,0,0,0,1,1,0
0,1,1,0,0,1,1,1,1,1,1,0
0,1,1,1,1,1,1,1,1,1,1,0
0,0,1,1,1,1,1,1,1,1,0,0
0,0,0,0,0,0,0,0,0,0,0,0
